##########
####.S.#.#
###....D.#
####D#####
#........#
#........#
####D#####
#....S...#
#.C......#
##########
