##########
####.S.#.#
##N....D.#
####D#####
#.....G..#
#...G....#
####D#####
#....S...#
#.C......#
##########
